XXXXXXXXXXXXX
XPNNNRNNRNNEX
XNXRXNXNXNXNX
XNNENNRENNXNX
XRXNXNXNXNXRX
XNRNNENNNDXDX
XXXXXXXXXXXXX