XXXXXXXXXXXXXXXXXXXXXXXX
XPNNNRNNRNNENNNRNNXNNENX
XNXRXNXNXNXNNNXNNNXNNNNX
XNNENNRENNXNNNRNXNRNNNNX
XRXNXNXNXNXRNNRNNNXNNXNX
XNRNNENNNXXXXXNXNNRNNNNX
XNXXXNNNNXXXXXXNNNXNNENX
XNXNNNNXXXXXXXDNNNXNNRNX
XEXNNNNRNNXNRNXNNNRNNNNX
XRXNXNNXNNNNRNXXXXXXXXXX
XNXNNNNRNNXNRNXXXXXXXXXX
XNNNRNNXNNNNNNNNNNNNNNRX
XXXXXXXXXXXXXXXXXXXXXXXX