XXXXXXXXXXXXXXXXXXXXXXX
XPNNNNNNNNNNNNNNERXNENX
XNXRXNXNXNXXXNXXXXXNNRX
XNNNNNRENNNNNNRNNRXXNNX
XRXNXNXNXNXXXNXXXNNRNNX
XNRNNNNNNDNNNNRNNNNNRNX
XXXXXXXXXXXXXXNXXXXXXXX
XNNRNNNNNNENNNNNXXXXRXX
XNNENNXNNXRXNNNNNNNNDXX
XXXXXXXXXXXXXXXXXXXXXXX