XXXXX
XNNNX
XNXRX
XPNNX
XXXXX