XXXXXXXXXXX
XPNNNNNNNNX
XNXRXNXNXNX
XNNNNNRENNX
XRXNXNXNXNX
XNRNNNNNNDX
XXXXXXXXXXX